NO ./pics/face.png

SO ./pics/2.png
WE ./pics/bluestone.png

C 3,173,252

EA ./pics/eagle.png
F 21,82,10

11111111111111111111111111111
10000000000000000000000000001
10000S00000000000000000010001
10002030444000000000000010001
10002030000000000000000010001
10000000001100000111011111111
11111111111111011100000010001
11110111111111011101010010001111
11000000110101011100000010000001
10000000000000001100000010001111
10000000000000001101010010001
11000000110101000000000011111
1111011111010100000010101
1000000000110000010000001
1000000000000000100010001
10000000001000010000000011111
10000000001111100000000000001
10000000001  1100001010000001
10000000001  1100001010000001
10000000001  1110001010000001
10000000001  1000000101000001
11111111111  1111111111111111
